     #                 #          #       #   #  #
      # #  # #     #  ##           ##      #  #   
               #    ##       #   ##  #            
   #  #            ##  #     #        #  #  #     
 #  #      ###          #   #           # # #     
           # #  # ##      #  ##       ##  ##  #   
     ##     #      #  ##   #                  # # 
            #  ## ##      ## #    # #      #  #   
##   ##     # # # # #     ## #     ##  # #        
#     # #   #       #    #   ##      #   ##     # 
#     ## #  #        ##  #    #            #  #   
     #   #    #     #     #    #  #     ##  #     
# #     #   #          #   ##       ## ##    # #  
     ####         #  #  #  #  #        # #        
    #  # #       #      ####                  # # 
     #  ##         ##   # #                 # ## #
    #      # #     # #    #               #   #   
     #      #        ##    #               ####   
#   ###               # ###     #        #  #     
 # ##   #       #      # #             #     # ## 
             #  #        #  #   #     # #      ## 
     #   ##   #        #  ##  ##        # #  #    
                    #          ##      # #    # # 
 #       #         # # #    ##    ###            #
    ## ##       ###            ##        #  ## #  
#   ## # #  ## ######             ##             #
     ##    # # #     # #   # ##  # #           #  
  ###                  #  # #     # #       #     
 #        ##  #  #                        ## #    
# #      #       #     ##     # #     ## #  ##    
        ##                #   #  #            #   
    #  ##   #      #          # ##     #  #   #   
  # ##       #      #      #  #  #          #     
            # #   #  #  #  ##              #      
             #           #   #     #   #    #     
  #         #  #     #   #           ## #   #     
##         #   #     # #         # ##       ###  #
          #    # #   #          ##       #        
 #       #        # ### ##  #  #   # #   #     #  
      ##   ##  #  #      ##    #      ##          
  #   #          #     #   #     ##       ##      
    #     #   #            #     #   #       #    
        #  # # #  #      # #  #        #     #    
   # #         # #      #       # #   #   #     # 
   ##  #  # ##         #      #  ##          #   #
     #      #   #   #      ##       #          #  
  #   # #  #         # #      ###             # # 
  #       ##   #  #    # # # #      ##  #   #  # #
#    # ##    # #           #  # #     ##          
    #  #          #               ###    #     #  
