 o# #  ###
#ooo#  # #
 # ooo# ##
#### oo ##
 ###  o# #
##  ##ooo#
##  ####o#
# ### # o 
#  #   #o#
#####  #o#
